CAAAAAAAAAAA
CA->CB
CBA->CAB
CBBA->CAAB
CBBBA->CAAAB
CBBBBA->CAAAAB
CBBBBBA->CAAAAAB
CBBBBBBA->CAAAAAAB
CBBBBBBBA->CAAAAAAAB
CBBBBBBBBA->CAAAAAAAAB
CBBBBBBBBBA->CAAAAAAAAAB
CBBBBBBBBBBA->CAAAAAAAAAAB
CBBBBBBBBBBB->ACAAAAAAAAAA
ACBBBBBBBBBB->BCAAAAAAAAAA
BCBBBBBBBBBB->AACAAAAAAAAA
ABCBBBBBBBBB->BACAAAAAAAAA
ACBBBBBBBBB->BCAAAAAAAAA
BBCBBBBBBBBB->AAACAAAAAAAA
ACBBBBBBBB->BCAAAAAAAA
ABCBBBBBBBB->BACAAAAAAAA
ABBCBBBBBBBB->BAACAAAAAAAA
BBBCBBBBBBBB->AAAACAAAAAAA
ACBBBBBBB->BCAAAAAAA
ABCBBBBBBB->BACAAAAAAA
ABBCBBBBBBB->BAACAAAAAAA
ABBBCBBBBBBB->BAAACAAAAAAA
BBBBCBBBBBBB->AAAAACAAAAAA
ACBBBBBB->BCAAAAAA
ABCBBBBBB->BACAAAAAA
ABBCBBBBBB->BAACAAAAAA
ABBBCBBBBBB->BAAACAAAAAA
ABBBBCBBBBBB->BAAAACAAAAAA
BBBBBCBBBBBB->AAAAAACAAAAA
ACBBBBB->BCAAAAA
ABCBBBBB->BACAAAAA
ABBCBBBBB->BAACAAAAA
ABBBCBBBBB->BAAACAAAAA
ABBBBCBBBBB->BAAAACAAAAA
ABBBBBCBBBBB->BAAAAACAAAAA
BBBBBBCBBBBB->CAAAAAAAAAAC
BC->CB
CC->AC